7;7
+-+-+-+-+-+-+-+
|       |     |  
+ + +-+ + +-+ +
| |     |   | |
+ + +-+ + + + +
|     | | | | |
+ +-+ + + + + +
| |   |   |   |
+ + +-+-+-+-+ +
| |     |     |
+ +-+ + + +-+ +
| |   | | |   |
+ + + + + + +-+
|   | |   |   |
+-+-+-+-+-+-+-+
